4 4 4 4 4 4 4 4 4 4 4 4 4 4 4 4 
4 1 1 1 1 1 1 1 1 1 1 1 1 1 1 4
4 1 5 0 0 0 0 0 0 0 0 0 0 5 1 4
4 1 5 0 0 0 0 0 0 0 0 0 0 5 1 4
4 1 5 0 0 0 0 0 0 0 0 0 0 5 1 4
4 1 5 0 0 0 0 0 0 0 0 0 0 5 1 4
4 1 5 0 0 0 0 0 0 0 0 0 0 5 1 4
4 1 5 0 0 0 0 0 0 0 0 0 0 5 1 4
4 1 5 0 0 0 0 0 0 0 0 0 0 5 1 4
4 1 5 0 0 0 0 0 0 0 0 0 0 5 1 4
4 1 5 0 0 0 0 0 0 0 0 0 0 5 1 4
4 1 5 0 0 0 0 0 0 0 0 0 0 5 1 4
